[console_scripts]
adjustoffset = rapidtide.scripts.adjustoffset:entrypoint
aligntcs = rapidtide.scripts.aligntcs:entrypoint
applydlfilter = rapidtide.scripts.applydlfilter:entrypoint
applyppgproc = rapidtide.scripts.applyppgproc:entrypoint
atlasaverage = rapidtide.scripts.atlasaverage:entrypoint
atlastool = rapidtide.scripts.atlastool:entrypoint
calcicc = rapidtide.scripts.calcicc:entrypoint
calctexticc = rapidtide.scripts.calctexticc:entrypoint
calcttest = rapidtide.scripts.calcttest:entrypoint
ccorrica = rapidtide.scripts.ccorrica:entrypoint
delayvar = rapidtide.scripts.delayvar:entrypoint
diffrois = rapidtide.scripts.diffrois:entrypoint
endtidalproc = rapidtide.scripts.endtidalproc:entrypoint
fdica = rapidtide.scripts.fdica:entrypoint
filtnifti = rapidtide.scripts.filtnifti:entrypoint
filttc = rapidtide.scripts.filttc:entrypoint
fingerprint = rapidtide.scripts.fingerprint:entrypoint
fixtr = rapidtide.scripts.fixtr:entrypoint
gmscalc = rapidtide.scripts.gmscalc:entrypoint
happy = rapidtide.scripts.happy:entrypoint
happy2std = rapidtide.scripts.happy2std:entrypoint
happywarp = rapidtide.scripts.happywarp:entrypoint
histnifti = rapidtide.scripts.histnifti:entrypoint
histtc = rapidtide.scripts.histtc:entrypoint
linfitfilt = rapidtide.scripts.linfitfilt:entrypoint
localflow = rapidtide.scripts.localflow:entrypoint
mergequality = rapidtide.scripts.mergequality:entrypoint
pairproc = rapidtide.scripts.pairproc:entrypoint
pairwisemergenifti = rapidtide.scripts.pairwisemergenifti:entrypoint
physiofreq = rapidtide.scripts.physiofreq:entrypoint
pixelcomp = rapidtide.scripts.pixelcomp:entrypoint
plethquality = rapidtide.scripts.plethquality:entrypoint
polyfitim = rapidtide.scripts.polyfitim:entrypoint
proj2flow = rapidtide.scripts.proj2flow:entrypoint
rankimage = rapidtide.scripts.rankimage:entrypoint
rapidtide = rapidtide.scripts.rapidtide:entrypoint
rapidtide2std = rapidtide.scripts.rapidtide2std:entrypoint
resamplenifti = rapidtide.scripts.resamplenifti:entrypoint
resampletc = rapidtide.scripts.resampletc:entrypoint
retrolagtcs = rapidtide.scripts.retrolagtcs:entrypoint
retroregress = rapidtide.scripts.retroregress:entrypoint
roisummarize = rapidtide.scripts.roisummarize:entrypoint
runqualitycheck = rapidtide.scripts.runqualitycheck:entrypoint
showarbcorr = rapidtide.scripts.showarbcorr:entrypoint
showhist = rapidtide.scripts.showhist:entrypoint
showstxcorr = rapidtide.scripts.showstxcorr:entrypoint
showtc = rapidtide.scripts.showtc:entrypoint
showxcorr_legacy = rapidtide.scripts.showxcorr_legacy:main
showxcorrx = rapidtide.scripts.showxcorrx:entrypoint
showxy = rapidtide.scripts.showxy:entrypoint
simdata = rapidtide.scripts.simdata:entrypoint
spatialdecomp = rapidtide.scripts.spatialdecomp:entrypoint
spatialfit = rapidtide.scripts.spatialfit:entrypoint
spatialmi = rapidtide.scripts.spatialmi:entrypoint
spectrogram = rapidtide.scripts.spectrogram:entrypoint
stupidramtricks = rapidtide.scripts.stupidramtricks:entrypoint
synthASL = rapidtide.scripts.synthASL:entrypoint
tcfrom2col = rapidtide.scripts.tcfrom2col:entrypoint
tcfrom3col = rapidtide.scripts.tcfrom3col:entrypoint
temporaldecomp = rapidtide.scripts.temporaldecomp:entrypoint
testhrv = rapidtide.scripts.testhrv:main
threeD = rapidtide.scripts.threeD:entrypoint
tidepool = rapidtide.scripts.tidepool:entrypoint
variabilityizer = rapidtide.scripts.variabilityizer:entrypoint
